Abbagliato: See Spendthrift Club.
Abel: Biblical second son of Adam and brother of Cain.
Abraham the Patriarch: Important biblical figure.
Absalom and Ahithophel: Absalom was the rebellious son of King David who was incited by Ahithophel, the king's councilor.
Achan: Ancient Israelite who stole from Jericho during Joshua's conquest. He was stoned to death for the theft. (Joshua 7:1вЂ“26)
Acheron: The mythological Greek underworld river over which Charon ferried souls of the newly dead into Hades.
Achilles: The greatest Greek hero in the Trojan War. An account well known in the Middle Ages has him killed by Paris after having been lured with the promise of Priam's daughter Polyxena.
Acre: Ancient city in Western Galilee, it was the last Christian possession in the Holy Land, finally lost in 1291. Inf. XXVII, 86.
Adam: According to the Bible, the first man created by God.
Adam of Brescia: See Master Adam.
"Adhaesit pavimento anima mea": ("My soul cleaveth unto the dust.") (Psalm 119:25; 118:25 in the Vulgate.)
Aegina: A Greek island between Attica and Argolis in the Saronic Gulf. According to tradition it was named by its ruler AeacusвЂ”son of Zeus and Aegina, daughter of the river-god AsopusвЂ”after his mother. In Ovid's Metamorphoses (VII, 501вЂ“660), Aeacus, tells of a terrible plague inflicted by a jealous Juno (Hera), killing everyone on the island but Aeacus; and how he begged Jupiter (Zeus) to give him back his people or take his life as well. Jupiter then turned the islands ants into a race of men called the Myrmidons, some of whom Achilles ultimately led to war against Troy.
Aeneas: Hero of Virgil's epic poem Aeneid, his descent into hell is a primary source for Dante's own journey.
Aeolus: Ruler of the winds in ancient Greek mythology. Purg. XXVIII, 21.
Aesop: A semi-legendary Greek fabulist of whom little reliable is known. A famous corpus of fables is traditionally assigned to him.
Africanus: Agnomen of Publius Cornelius Scipio Africanus (236вЂ“183 BCE), the Roman general who defeated the Carthaginian general Hannibal in the Second Punic War.
Agathon: Greek poet of the 5th century BCE.
Agapetus: Pope from 535 to 536.
Aglauros: Athenian princess who envied her sister's love affair with Hermes. When she attempted to block Hermes' access, he changed her to stone.
Agnus Dei: Liturgical anthem addressed to Jesus as Lamb of God. Sung while the Eucharistic bread is being divided. It ends with "Dona nobis pacem." ("Grant us peace.")
Ahasuerus: Ancient King of Persia according to the Book of Esther. He married Esther, whose father was Mordecai. Haman, the prime minister, became enraged at Mordecai for refusing to bow in his presence. Haman then plotted a pogrom of the Jews in the kingdom. The plot was discovered, and Ahasuerus had Haman executed.
Ahithophel: See Absalom.
Alardo: See Tagliacozzo.
Alba: Town in Latium near Rome which founded the Latin League in the early years of Rome.
Albert I of Germany: Roman-German King (1298вЂ“1308) from the Habsburg family. He was King during the events of the Comedy.
Alberto da Casalodi: Guelph count of Brescia, he was Signore of Mantua during the feuding between Guelphs and Ghibellins. He was ousted in 1273 by his advisor Pinamonte dei Bonacolsi.
Alberto da Siena: See Griffolino of Arezzo.
Albertus Magnus (c. 1197вЂ“1280): Dominican friar, scholar, and teacher of Thomas Aquinas.
Alcmaeon: Son of Eriphyle, who presumed herself worthy to wear jewelry designed for the gods. Her presumption resulted in her husband's death. Alcmaeon murdered his mother in revenge.
Tegghiaio Aldobrandi: Florentine son of the famous Aldobrando degli Adimari, he was podestГ  of Arezzo in 1256 and fought at the battle of Montaperti in 1260, where his warnings against attacking the Senese forces went unheeded, and the Florentines were annihilated.
Alecto: see Erinyes.
Alexander the Great: King of Macedon (356вЂ“323 BCE) and the most successful military commander of ancient history
Ali: Cousin and son-in-law of Muhammad, and one of his first followers. Disputes over Ali's succession as leader of Islam led to the split of Islam into the sects of Sunni and Shi'a.
Amphiaraus: Mythical king of Argos and seer, who although he had foreseen his death, was persuaded to join the expedition of the Seven against Thebes. He was killed while fleeing from pursuers, when Zeus threw a thunderbolt, and the earth opened up and swallowed him.
Anagni: ancient town in central Italy. Birthplace of Pope Boniface VIII.
Pope Anastasius II: Pope who Dante perhaps mistakenly identified with the emperor Anastasius I and thus condemned to hell as a heretic. Anastasius I was a supporter of Monophysitism, a heresy which denied the dual divine/human nature of Jesus.
Anaxagoras (c. 500вЂ“428 BCE): Greek philosopher.
Anchises: Father of Aeneas by Aphrodite. In the Aeneid he is shown as dying in Sicily.
Loderingo AndalГІ (c. 1210вЂ“1293): Of a prominent Ghibelline family, he held many civic positions. In 1261 he founded the Knights of Saint Mary or Jovial Friars, a religious order recognized by Pope Clement IV. Its mission was to promote peace between warring municipal factions, but its members soon succumbed to self-interest. Together with Catalano dei Malavolti, he shared the position of governor of Florence. Loderingo is extolled for his fortitude in dying by his friend, the poet Guittone d'Arezzo.
Andrea de' Mozzi: Chaplain of the popes Alexander IV and Gregory IX, he was made bishop of Florence in 1287 and there remained until 1295, when he was moved to Vicenza, only to die shortly after.
Angiolello di Carignano: See Malatestino.
Anglo-Scottish War: the state of endemic conflict between England and Scotland in which neither side could 'remain within their borders'.
Annas: The father-in-law of Caiaphas, he also is called High-Priest. He appears to have been president of the Sanhedrin before which Jesus is said to have been brought.
Antaeus: Son of Neptune and Gaia. A giant whose invincible strength came from contact with the earth. Hercules killed him by lifting him from the earth and crushing him.
Antigone and Ismene: Theban princesses and daughters of Oedipus and Jocasta who appear in several ancient plays.
Antiochus IV Epiphanes (c. 215вЂ“163 BCE): Last powerful Seleucid king, he is famous principally for his war against the Maccabees.
Apollo: Greek god of the sun, music and prophecy who led the Muses, the goddesses who inspired literature and arts.
Apulia: A region in southeastern Italy bordering the Adriatic Sea in the east, the Ionian Sea to the southeast, and the Strait of Otranto and Gulf of Taranto in the south. In the Middle Ages, it referred to all of southern Italy. The barons of Apulia broke their promise to defend the strategic pass at Ceperano for Manfred, the son of Frederick II, and allowed Charles of Anjou to pass freely into Naples. Manfred was subsequently killed (1266) at the Battle of Benevento, a crucial blow to the Ghibelline cause.
Aquarius: The eleventh sign of the zodiac. When the sun is in Aquarius (between January 21 and February 21), the days start to visibly grow longer and day and night begin to approach equal length. Inf. XXIV, 1вЂ“3.
Thomas Aquinas: Dominican theologian considered to be one of the greatest scholars of the Church.
Arachne: In Greek mythology, a woman who challenged Athena to a contest of skill in weaving. Athena destroyed her work and converted the woman into a spider.
Arcolano of Siena: A member of the Maconi family, he was a member of the notorious Sienese Spendthrift Club. He fought in the Battle of Pieve al Toppo in 1288, where according to Giovanni Boccaccio, he preferred to die in battle rather than live in poverty.
Arethusa: In Greek mythology she was a nymph daughter of Nereus. Running away from a suitor, Alpheus, she was transformed by Artemis into a fountain.
Filippo Argenti: A Black Guelph and member of the Adimari family, who were enemies of Dante. Inf. VIII, 31вЂ“66.
Argia: Ancient Theban woman, sister of Deipyle and wife of Polynices.
Argus: Giant of ancient Greek mythology with multiple eyes.
Ariadne: Daughter of Minos, king of Crete, who helped Theseus kill the Minotaur, the offspring of Ariadne's mother PasiphaГ« and a bull.
Aristotle: 4th-century BCE Greek philosopher whose writings were a major influence on medieval Christian scholastic philosophy and theology, particularly on the works of Thomas Aquinas.
Argives: People of Argos, or more generally all Greeks Inf. XXVIII, 84.
Arles: City in the south of France and supposed location of the tombs of Charlemagne's soldiers who fell in the battle of Roncesvalles.
Arno: River which runs through Florence.
Aruns: In Lucan's epic poem Pharsalia, he is the Etruscan seer who prophesies the Civil war, Caesar's victory over Pompey, and its ending in 48 BCE.
Asdente: See Mastro Benvenuto.
"Asperges me" ("Thou shalt sprinkle me"): Psalm 51:9 (Psalm 50:9 in the Vulgate Bible). Opening of the Asperges, a hymn sung during the sprinkling of a congregation with Holy Water. "Thou shalt sprinkle me with hyssop, and I shall be cleansed: thou shalt wash me, and I shall be made whiter than snow."
Athamas: See Hera.
Athena: Greek Goddess of Wisdom. "Pallas" is a widely used epithet for her.
Athens: Major Greek city of antiquity.
Attila the Hun (c. 406вЂ“453): King of the Huns, known in Western tradition as the "Scourge of God".
Augustus (63 BCE вЂ“ 14 CE): The Roman Emperor under whom Virgil found fame as a poet.
Aurora: Roman goddess of dawn
Ave: "Ave gratia plena, Dominus tecum." (Hail, highly favored one, the Lord is with you.) Words addressed by the angel Gabriel to the Virgin Mary, announcing the birth of Jesus.
Ave Maria: Prayer to the Virgin Mary.
Averroes (1126вЂ“1198): Andalusian-Arab philosopher, physician, and famous commentator ("il gran comento") on Aristotle.
Avicenna (980вЂ“1037): Persian physician, philosopher, and scientist. He wrote commentaries on Aristotle and Galen.
Azzo VIII: Lord of Ferrara, Modena and Reggio from 1293 until his death in 1308. He was rumoured to have murdered his father Obizzo II d'Este.
Bacchus: The Roman name of the Greek god Dionysus, protector of wine.
Barbarossa: Frederick I Barbarossa, Holy Roman Emperor (1155вЂ“1190). He captured Milan in his Italian campaign in 1154. Purg. XVIII, 119.
Barrators: Those who have committed the sin of barratry.
Barratry: The sin of selling or paying for offices or positions in the public service or officialdom (cf. simony).
"Beati misericordes": "Blessed are the merciful." (Mat 5:7)
"Beati mundo corde": "Blessed are the pure in heart." (Mat 5:8).
"Beati pacifici": "Blessed are peacemakers." (Mat 5:9)
"Beati pauperes spiritu": "Blessed are the poor in spirit." (Mat 5:3)
"Beati quorum tecta sunt peccata": "Blessed are they whose sins are covered." (Psalm 32:1; Psalm 31:1 in the Latin Vulgate.)
Baptist: See John the Baptist.
Beatrice (1266вЂ“1290): Dante's idealised childhood love, Beatrice Portinari. In the poem, she awaits the poet in Paradise, replaces Virgil as Dante's guide, and conducts him through the heavens. She symbolises Heavenly Wisdom.
Saint Bede: English monk, and scholar, whose best-known work, Historia ecclesiastica gentis Anglorum (The Ecclesiastical History of the English People) gained him the title "The father of English history".
Belacqua: Personal acquaintance of Dante's, perhaps Duccio di Bonavia, a music instrument maker noted for his laziness.
Belisarius: (c. 500вЂ“565) Roman general who served under the Emperor Justinian and regained much of Italy for the Empire.
"Benedictus qui venis" ("Blessed are you who come") Variation of "Benedictus qui venit" ("Blessed is he who comes"), sung in the Sanctus of the Latin Mass. The phrase comes from the Gospel of Mark (Mark 11:10), when the crowds welcome Jesus into Jerusalem.
Mastro Benvenuto: Nicknamed Asdente ("toothless"), he was a late 13th-century Parma shoemaker, famous for his prophecies against Frederick II. Dante also mentions him with contempt in his Convivio, as does Salimbene in his Cronica, though with a very different tone.
Gualdrada Berti: Daughter of Bellincione Berti dei Ravignani, from about 1180 wife to Guido the Elder of the great Guidi family, and grandmother of Guido Guerra. The 14th-century Florentine chronicler Giovanni Villani remembers her as a model of ancient Florentine virtue.
Bertran de Born (c. 1140 вЂ“ c. 1215): French soldier and troubadour poet, and viscount of Hautefort, he fomented trouble between Henry II of England and his sons.
Bonagiunta of Lucca: Tuscan poet. He uses the phrase "dolce stil novo" to describe the poetry of Dante, Guido Guinizelli, and Guido Cavalcanti. Purg. XXIV, 43вЂ“63.
Guido Bonatti: A prominent 13th-century astrologer, and a staunch Ghibelline, he is famous for having boasted of being responsible for the Senese victory at Montaperti in 1260.
Bonaventure: Franciscan theologian.
Buonconte: Son of military strategist Guido da Montefeltro, he helped expel the Guelph party from Arezzo in 1287. His army was defeated by Guelphs from Florence at the Battle of Campaldino in 1289. Dante fought for Florence in the battle. Buonconte's body was not found after the battle.
Pope Boniface VIII (c. 1235вЂ“1303): Elected in 1294 upon the abdication of Celestine V, whom he promptly imprisoned. He supported the Black Guelphs against Dante's party the White Guelphs (see Guelphs and Ghibellines). He was in conflict with the powerful Colonna family, who contested the legitimacy of Celestine's abdication, and thus Boniface's papacy. Wishing to capture the impregnable Colonna stronghold of Palestrina, he sought advice from Guido da Montefeltro, offering in advance papal absolution for any sin his advice might entail. He advised Boniface to promise the Colonnas amnesty, then break it. As a result, the Collonas surrendered the fortress and it was razed to the ground.
Martin Bottario: A cooper of Lucca who held various positions in the government of his city. He died in 1300, the year of Dante's travel.
Brennus: Gaulic king who invaded Rome and held the city for ransom in the 4th century BCE.
Briareus: Son of Uranus and Gaia and one of the Hekatonkheires ("hundred-handed")
Agnello Brunelleschi: From the noble Florentine Brunelleschi family, he sided first with the White Guelphs, then the Blacks. A famous thief, he was said to steal in disguise.
Brutus, Lucius Junius: Traditionally viewed as the founder of the Roman Republic, because of his role in overthrowing Tarquin, the last Roman king.
Brutus, Marcus Junius (died 43 BCE): One of the assassins of Julius Caesar, with whom he had close ties. His betrayal of Caesar was famous ("Et tu Brute") and along with Cassius and Judas, was one of the three betrayer/suicides who, for those sins, were eternally chewed by one of the three mouths of Satan. Inf. XXXIV, 53вЂ“67.
Bulicame: Spring near Viterbo renowned for its reddish colour and sulphurous water. Part of its water was reserved for the use of prostitutes. Inf. XIV, 79вЂ“83.
Caccia d'Asciano: See Spendthrift Club.
Venedico and Ghisolabella Caccianemico: Venedico (c. 1228 вЂ“ c. 1302) was head of the Guelph faction in Bologna, he was exiled three times for his relationship with the marquess of Ferrara, Obizzo II d'Este.
Cacus: A mythological monster son of Hephaestus, he was killed by Heracles for stealing part of the cattle the hero had taken from Geryon. Dante, like other medieval writers, erroneously believes him to be a Centaur. According to Virgil he lived on the Aventine.
Cadmus: Mythical son of the Phoenician king Agenor and brother of Europa, and legendary founder of Thebes. Cadmus and his wife Harmonia are ultimately transformed into serpents. (See also Hera.)
Caecilius: Roman poet of the 2nd century BCE.
Cahors: Town in France that was notorious for the high level of usury that took place there and became a synonym for that sin.
Cain: The son of Adam and brother of Abel. He murdered his brother out of envy.
A popular tradition identified the Moon's dark spots as the marks on Cain's face mentioned in Genesis 4:15. Inf. XX, 126, Par. II, 49вЂ“51.
He is an example of envy. His voice is heard on the terrace of the envious saying, "Everyone who finds me will slay me." (Gen 4:14) Purg. XIV, 133.
Caiaphas: The Jewish High Priest during the governorship of Pontius Pilate of the Roman province of Judea, who according to the Gospels had an important role in the crucifixion of Jesus.
Calchas: Mythical Greek seer at the time of the Trojan war, who as augur at Aulis, determined the most propitious time for the Greek fleet to depart for Troy.
Calliope: The Muse of epic poetry.
Camilla: Figure from Roman mythology and Virgil's Aeneid (VII, 803; XI), was the warrior-daughter of King Metabus of the Volsci, and ally of Turnus, king of the Rutuli, against Aeneas and the Trojans, and was killed in that war.
Cangrande della Scala (1290вЂ“1329): Ghibelline ruler of Verona and most probable figure behind the image of the "hound" ("il Veltro"). Inf. I, 101вЂ“111.
Capaneus: In Greek mythology, in the war of the Seven against Thebes, he defied Zeus who then killed him with a thunderbolt in punishment.
Capocchio: Burned at the stake for alchemy in 1293.
Caprona: Fortress on the Arno near Pisa, in 1289, it was besieged by a Tuscan Guelph army. The Ghibellines surrendered, and were allowed, under truce, to leave the castle, passing through (with trepidation) the enemy ranks. Caprona's fall along with the Guelph victory in the same year at Campaldino represented the final defeat of the Ghibellines. Dante's reference to Caprona in the Inferno, is used to infer that he took part in the siege.
Cardinal Virtues: The foundations of a moral life, attainable by all, regardless of religion. They include Prudence, Temperance, Justice, and Fortitude.
Casella: Florentine composer and singer (died before 1300) and friend of Dante's, who set at least one poem from Dante's Convivio to music. Purg. II.
Cassius: The most senior of Julius Caesar's assassins, Gaius Cassius Longinus was a Roman politician and soldier.
Castel Sant'Angelo: A Papal castle in Rome with bridge attached. Inf. XVIII, 28вЂ“33.
Catalano dei Malavolti (c. 1210вЂ“1285): From a powerful Guelph family of Bologna, he was podestГ  in several towns, including Florence, and governor of his city. He was commander of the infantry in the Battle of Fossalta in 1249, when the Ghibellines suffered a crushing defeat. He later became a member of the Knights of St. Mary, founded by Loderingo degli AndalГІ.
Catiline: a Roman politician of the 1st century BCE who is best known for the "Catiline conspiracy", an attempt to overthrow the Roman Republic, and in particular the power of the aristocratic Senate.
Cato the Younger (95вЂ“46 BCE) : Politician and statesman in the late Roman Republic, and a Stoic.
Cavalcante de' Cavalcanti: (died c. 1280) Father of Guido Cavalcanti, his shade appears to Dante, alongside the shade of Farinata degli Uberti. Inf. X 52вЂ“72.
Guido Cavalcanti (c. 1255вЂ“1300): First Florentine poet of Dolce Stil Novo, close friend of Dante and son of Cavalcante de' Cavalcanti. Inf. X, 56вЂ“63, Purg. XI, 97вЂ“98.
Francesco de' Cavalcanti: Nicknamed Guercio ("one-eyed" or "squinter"), he was murdered for unknown reasons by the inhabitants of the village of Gaville, near Florence. Reportedly his death started a bloody feud between his family and the villagers, leaving most of the inhabitants of Galville dead.
Cecina: See Maremma.
Pope Celestine V: A hermit named Pietro da Morrone, he abdicated the Papacy in 1294 after only five months. His successor, Boniface VIII, immediately jailed him and two years later apparently murdered him.
Centaurs: In Greek mythology, a race part Man and part horse, with a horse's body and a human head and torso.
Ceperano: See Apulia.
Cerberus: In Greek mythology, he was the three-headed dog who guarded the gate to Hades. In the Aeneid, Virgil has the Sibyl throw a drugged honey cake into Cerberus' mouths; in the Inferno, Dante has Virgil throw dirt instead.
Cesena: City on the Savio River during Dante's time, though free, its politics were controlled by Guido da Montefeltro's cousin Galasso da Montefeltro. Inf. XXVII, 52вЂ“54.
Charles the Lame: Son of Charles of Anjou and King of Naples (1285вЂ“1309)
Charles of Anjou (also Charles I of Sicily) (1227вЂ“1285): Son of Louis VIII of France, he was one of the most powerful rulers of his age and the undisputed head of the Guelph faction in Italy. His dream of building a Mediterranean Empire was wrecked by the Sicilian Vespers.
Charles of Valois: (1270вЂ“1325) Second son of Philip III of France. Invaded Italy and took Florence in 1301, placing the Black Guelphs in power. Subsequently, Dante was exiled from Florence.
Charybdis: In Greek mythology, a sea monster who swallows huge amounts of water three times a day and then spouts it back out again, forming an enormous whirlpool. Mentioned frequently by classical writers.
Charon: The mythological Greek figure who ferried souls of the newly dead into Hades over the underworld river Acheron. Inf. III, 82вЂ“129.
Chiron: Leader of the centaurs, legendary tutor of Achilles. Inf. XII, 65.
Ciacco ("pig"): Nickname, for a Florentine contemporary of Dante, perhaps well known as a glutton, and probably the same who appears in Boccaccio's Decameron (IX, 8).
Ciampolo di Navarra: Utterly unknown to sources other than Dante, this Ciampolo (i.e. Jean Paul) appears to have been in the service of Theobald II, king of Navarre.
Cicero, Marcus Tullius (c. 106 вЂ“ c. 43 BCE): Roman statesman and author.
Cimabue: Florentine painter (c. 1240вЂ“1302)
Circe: Mythical daughter of Helios, god of the Sun, and sister of Aeetis, king of Colchis. She was an enchantress who lived near the Gulf of Gaeta, who turned the crew of Odysseus into pigs on their journey home from the Trojan war. But Odysseus, with the help of Hermes, forced her to release his men from her spell (Ovid, Met. XIV, 435вЂ“440). She fell in love with Odysseus and he stayed with her for another year and in some accounts, she had a son Telegonus with Odysseus, who was to accidentally kill him.
Cirra: Town in ancient Greece near Parnassus. Par. I, 36.
Pope Clement V (1264вЂ“1314): Born in France as Bertran de Goth, he was made archbishop of Bordeaux by Pope Boniface VIII. He was elected pope in 1305 and was remarkable for his dissolution of the Templars and his de facto move of the Papal See from Rome to Avignon (See Avignon Papacy). He was thought to have negotiated with Philip IV of France for his papacy, becoming a puppet of the French monarchy.
Cleopatra (69вЂ“30 BCE): Queen of Egypt, lover of Julius Caesar and Mark Antony. Like Dido, she "killed herself for love".
Clio: The Muse of History.
Clotho: The Fate who determines the lifespan of each mortal by measuring out thread and then cutting it.
Cluny: A Benedictine monastery founded in 909, in Burgundy. The elegant robes of the Cluniacs are described with irony in a letter of Saint Bernard, a Cistercian, to his nephew Robert, who had left the Cistercians to join the Cluniacs.
Cocytus: "The river of lamentation", in Greek mythology, it was the river on whose banks the dead who could not pay Charon wandered. It flowed into the river Acheron, across which lay Hades. In the Inferno it is a frozen lake forming the ninth circle and the bottom of Hell.
Colchis: Ancient kingdom at the eastern end of the Black Sea. According to ancient Greek legend, Jason and the Argonauts sailed there in search of the Golden Fleece.
Conradin: (1252вЂ“1258) King of Sicily until 1258, when he was defeated and deposed by Charles of Anjou. Purg. XX, 68.
Constance (Constanza): Queen of Sicily in the 12th century and mother of Emperor Frederick II.
Constantine the Great (272вЂ“337): The famous Roman Emperor who passed the Edict of Milan in 313 and converted to Christianity. According to medieval legend, Constantine was inflicted with leprosy because of his persecution of Christians, and in a dream was told to seek out Pope Silvester on Mount Soracte, who baptised and cured him. According to the forged document, the Donation of Constantine, Constantine gave to the Pope the power to rule over Rome and the Western Roman Empire, which Dante sees as the source of the corruption of the Papacy.
Cornelia Africana (c. 190вЂ“100 BCE): daughter of Scipio Africanus Major, and mother of Tiberius and Gaius Gracchus.
Corneto: See Maremma.
Cronus: In Greek mythology, King of Crete during the Golden Age. He had several children by Rhea, but swallowed them at birth because he had learned from his parents Gaia and Uranus, that he was destined to be overthrown by a son. However, Rhea managed to save Zeus who eventually fulfilled that prophecy.
Crassus: Roman general who amassed the largest fortune in Roman history. He died in a battle with the Parthians. A story later circulated that the Parthians poured molten gold into his mouth.
Cited on the terrace of the greedy as an example of greed. "Tell us, Crassus, because you know: How does gold taste?" Purg. XX, 116вЂ“117.
Cunizza da Romano (1198вЂ“c. 1279): sister of Ezzelino III da Romano. Par. IX, 13вЂ“66.
Gaius Scribonius Curio: A distinguished orator, and supporter of Pompey the Great, he switched his support to Julius Caesar after Caesar paid his debts. Lucan (Phars I 270вЂ“290) has Curio urge Caesar persuasively, to quickly cross the Rubicon and invade Rome.
Cyclops: Children of Uranus and Gaia, they were giants with a single eye in the middle of their forehead. In Roman mythology, they helped Vulcan make thunderbolts for Zeus.
Cytherea: Alternative name for Aphrodite or Venus, the goddess of love. Also, the planet Venus.
Daedalus: In Greek mythology, he was a legendary inventor and craftsman. He designed the Labyrinth, and fashioned wings for himself and his son Icarus, enabling them to fly.
Daniel: Protagonist in the Book of Daniel of the Hebrew Bible. He and his companions fasted rather than incur ritual defilement when they ate in the court of the king of Babylon.
Bonturo Dati (died 1324): Head of the popular faction in Lucca, he expelled his enemies in 1308 assuming the government of the city, boasting he would put an end to barratry. He is famous for provoking with his jeers in 1313 a war with Pisa, that has been remembered in Faida di Comune by GiosuГЁ Carducci.
King David: Biblical king of the Jews. His counselor Ahithophel, incited David's son Absalom against him.
Decii: Three generations of men in a Patrician Roman family, who each answered the call to arms and died in battle.
Deianira: Wife of Heracles, she was abducted by the centaur Nessus, but Heracles shot him with a poisoned arrow. She was tricked by the dying Nessus into believing that a love potion could be made from his blood, which she later gives to Heracles poisoning him. Inf. XII, 68.
Deidamia: Mythical daughter of Lycomedes, king of Scyros, she gave birth to Achilles' only son, Pyrrhus Neoptolemus, but died of grief when, because of the urgings of Odysseus (Ulysses), Achilles left her to go to the war against Troy.
Deipyle: Ancient Greek wife of Tydeus and mother of Diomedes.
"Delectasti": ("Quia delectasti me, Domine, in factura tua": "For thou hast given me, O Lord, a delight in thy doings.") Psalm 92:5 (91:5 in the Latin Vulgate)
Democritus (c. 460вЂ“370 BCE): Pre-Socratic Greek philosopher.
"Deus, venerunt gentes": ("O God, the heathen have come.") Incipit of Psalm 79 (Psalm 78 in the Vulgate)
Diana: Greco-Roman goddess, known as the "virgin goddess."
Dido: Queen of Carthage. In Virgil's Aeneid, she becomes the lover of Aeneas despite a vow of eternal fidelity to her dead husband Sichaeus. Consequently, as "colei, che s' ancise amorosa" (she who killed herself from love"), Dante places her amongst the sexual sinners. Inf. V, 61вЂ“62.
Diogenes of Sinope (c. 412вЂ“323 BCE): Greek philosopher.
Diomedes: Mythical king of Argus, he participated in the expedition against Troy, where his prowess is extolled in the Iliad. A great friend of Odysseus (Ulysses), he was his companion in many feats, most notably the theft of Troy's Palladium and the ruse of the Trojan Horse.
Dionysius the Areopagite (fl. c. 50): Athenian judge who was converted to Christianity and became a bishop of Athens. As was common in the Middle Ages, Dante has confused him with Pseudo-Dionysius, the anonymous 5th-century author of Celestial Hierarchy.
Dionysius the Elder: Tyrant of Syracuse (405вЂ“367 BCE).
Pedanius Dioscorides (c. 40 вЂ“ c. 90): Greek physician and author of a work on the medicinal properties of plants, hence Dante's description of him as "il buono accoglitor del quale"/"the good collector of the qualities".
Dis: Another name for Pluto, the Roman god of the underworld, used by Dante as both the name of Satan and his realm.
Fra Dolcino: In 1300 he headed the Apostolic Brothers, a reformist order which, inspired by the example of St. Francis renounced all worldly possessions. He and his followers were condemned as heretics by Clement V, and fled into the hills near Novara. Facing starvation they surrendered and Dolcino was burned at the stake in 1307.
Among the "sowers of dissension", Muhammad, says to Dante: "tell Fra Dolcino to provide himself with food, if he has no desire to join me here quickly". Inf. XXVIII, 22вЂ“63.
Saint Dominic: Founder of the Dominican Order.
Domitian: Roman Emperor (81вЂ“96). His religious policies resulted in persecution of Christians and Jews.
Buoso Donati: Of the noble Florentine Black Guelph Donati family, he was one of those who accepted the peace between the factions proposed by Cardinal Latino in 1280. He died around 1285.
Cianfa Donati: Of the Donati family, he is known to have acted as advisor to the Capitano del popolo in 1281. In 1289 he is reported as already dead.
Forese Donati (?вЂ“1296): A Florentine poet, friend of Dante, and relative of Dante's wife, Gemma Alighieri.
Piccarda Donati: Sister of Forese Donanti, already dead at the time setting of the Comedy.
Eagle: Bird which appeared on the Standard of the Roman Legions and symbolized the authority of the empire.
Ebro: River in Spain.
Ecce ancilla Dei: "Behold the handmaid of God." (In the original Vulgate: "Ecce ancilla Domini.") Response of the Virgin Mary to the angel Gabriel when he announced that she would be the mother of Jesus.
Electra: Mother of Dardanus founder of Troy and ancestor of Aeneas.
Elijah and Elisha: Elijah was an Old Testament Biblical Prophet who ascends into heaven in a chariot of fire, and Elisha was his disciple and chosen successor who witnessed Elijah's ascent. Elisha curses some youths for ridiculing him, who are then eaten by bears (2 Kings 2:23вЂ“24; 11вЂ“12)
Empedocles (c. 490 вЂ“ c. 430 BCE): Greek Presocratic philosopher.
England: see Anglo-Scottish War
Ephialtes: Son of Poseidon and Iphimedeia, Ephialtes was a giant who attempted to scale Mt. Olympus by piling mountains on each other.
Erard de ValГ©ry: See Tagliacozzo.
Erichtho: According to a story in Lucan's Pharsalia, she was a sorceress sent to the underworld by Sextus Pompeius to divine the outcome of the upcoming battle of Pharsalia between his father, Pompey the Great, and Julius Caesar.
Erinyes: (also known as the Furies). In Greek mythology, they were Alecto, Megaera, and Tisiphone, three female personifications of vengeance.
Erysichthon: Ancient King of Thessaly who cut down a grove of trees sacred to Demeter. Her revenge was to give him insatiable hunger which eventually caused him to consume his own flesh.
Eteocles and Polynices: Mythical sons of Oedipus and Jocasta, they succeeded their father as kings of Thebes. Eteocles' refusal to share the throne led to the war of the Seven against Thebes, in which the two brothers killed each other. Their enmity in life was such that Statius (Thebais XII, 429 ff.) says even the flames of their shared funeral pyre were divided.
Ethiopia: empire of the Abyssinian people situated on the Horn of Africa under the Solomonic dynasty (1270-1974).
Euclid (c. 365вЂ“275 BCE): Greek mathematician, now known as "the father of geometry".
Eunoe: River originating in Terrestrial Paradise which shares a common source with the River Lethe. To drink from the Eunoe is to recall to memory all the good deeds of one's life after losing all memory in the River Lethe.
Euripides: Greek playwright of the 5th century BCE.
Euryalus: Friend of Nisus, he is a Roman mythological who appears in the AeneidвЂ”one of those who "died for Italy". Inf. I, 106вЂ“108
Eurypylus: He was a member of the Greek army that conquered Troy. It is told that while the fleet was at Aulis he was sent to the Delphic Sibyl to ask for a favourable wind.
Ezekiel: Jewish Prophet and author of a book of the Old Testament.
The four beasts of his vision (Ezekiel 1:1вЂ“28) appear as allegories of the four Gospels in the Pageant of the Church Triumphant. Purg. XXIX, 100вЂ“102.
Ezzelino da Romano III (1194вЂ“1259): Leader of the Ghibellines in Northern Italy, known for his cruelties against the citizens of Padua.
Fabii: Roman family of the Republican Age.
Fabricius: Caius Fabricius, famous Roman hero of the 3rd century BCE. He is remembered for his frugality and his refusal to accept substantial bribes from Pyrrhus.
Falterona: Mountain in the Apennine Range
Farinata degli Uberti (died 1264): Leader of the Florentine Ghibellines famous for his defeat of the Guelphs (Dante's faction), at the Battle of Montaperti in 1260, causing the Guelphs to be exiled from Florence, though he was able to argue successfully against the destruction of the city. Farinata was posthumously condemned as a heretic during the Franciscan inquisition of 1283. To make peace between the Black and White Guelphs, Cavalcante de' Cavalcanti, let his son Guido Cavalcanti, the future poet, marry Farinata's daughter.
Fiumicello: Tributary of Phlegethon. Inf. XIV, 77.
Fleur-de-lis: Flower symbolizing the French crown. Purg. XX, 86.
Florence: Dante's home city. He was exiled from Florence in 1302 and never returned. The Comedy was composed during the period of exile.
Folquet de Marseilles (c. 1165вЂ“1231): Troubadour, then Cistercian monk, and later Bishop of Toulouse.
Rampino Foresi: See Vanni Fucci.
ForlГ¬: City in Romagna. In 1282, under Guido da Montefeltro, it withstood a combined siege by French and Guelph forces, dealing the French a crushing defeat. After 1300 it was ruled by the Ordelaffi.
Fortuna: In Dante's cosmology, a power created by god to "guide the destinies of man on earth" (H. Oelsner, P.H. Wicksteed and T. Okey The Divine Comedy of Dante Alighieri, Vol I, p. 79). Inf. VII, 61вЂ“96, XV, 91вЂ“96.
Fortuna major: figure formed by a combination of the last stars of Aquarius and the first of Pisces. Used by geomancers for divination.
Fox: Animal often used to symbolize deceit or cunning.
Francesca da Rimini: See Paolo and Francesca.
Francesco d'Accorso: Eminent jurist of Bologna who taught law at the universities of Bologna and Oxford. Son of the great Florentine jurist Accorsio da Bagnolo, author of the Glossa Ordinaria on the Corpus Iuris Civilis.
Saint Francis of Assisi (1182вЂ“1226): Son of a wealthy merchant, he spurned his father's riches and founded the Franciscan Order, formally recognized by Pope Honorius III in 1223.
Franco Bolognese: 14th-century manuscript illuminator.
Frederick II, Holy Roman Emperor: Was renowned for his Epicurean lifestyle, and alleged to have punished traitors by cloaking them in leaden capes and placing them into boiling cauldrons.
Vanni Fucci: Nicknamed Bestia, for his brutality, he was the Illegitimate son of Fuccio de' Lazzari. He took part in the vicious struggles that divided his city Pistoia, siding with the Black Guelphs, repeatedly sacked the houses of his political enemies. In 1293, he stole the reliquary of San Jacopo from the sacristy of the Cathedral of Pistoia, for which crime the innocent Rampino Foresi was arrested and nearly executed, before the guilt of Fucci and his accomplices was discovered.
Furies: see Erinyes.
Gabriel: One of the Archangels of Christian tradition. He was the angel who announced the conception of Jesus to the Virgin Mary.
Galen (131вЂ“201): Ancient Greek physician.
Ganymede: Young Trojan prince abducted by Zeus in the form of an eagle and carried to Olympus to serve as cupbearer in the court of the gods.
Garisenda: A 160-foot leaning tower in Bologna built in the 12th century.
Geomancer: interpreter of patterns formed by tossed handfuls of soil, rocks, or sand. Purg. XIX, 3.
Geri del Bello: A second cousin of Dante. Apparently he was killed by the Sacchetti family and avenged by the Alegheri in 1310, with the feud continuing until 1342.
Geryon: In Greek mythology, son of Chrysaor and Callirhoe, was a winged giant. The tenth labour of Herakles was to steal his cattle. In Medieval times, he was viewed as an example of treacherous deception, which may explain Dante's choice of him as an emblem of fraud.
Gideon: Hero of ancient Israel. According to Judges 7:4вЂ“7, he selected the best warriors by the way they drank their water.
Giotto: Florentine painter. (1266/7вЂ“1337)
Giovanni di Buiamonte dei Becchi: Florentine banker, he had held several important offices which earned him a knighthood.
Glaucus: Ancient Greek mortal changed into an immortal sea god by eating magical reeds at the sea-shore.
Gloria in excelsis Deo: "Glory to God in the Highest." Opening of a canticle sung in morning prayer services and at the beginning of the Latin Mass.
Fra Gomita: Chancellor of Nino Visconti and Governor of the giudicato of Gallura, in SardiniaвЂ”at the time a possession of Pisa. He accepted a bribe to let escape a group of Visconti's enemies who were in his custody. For this he was hanged.
Gratian: 12th-century canon lawyer and Camaldolese monk.
Pope Gregory: Gregory I "the Great" (590вЂ“604).
Griffin: Legendary creature with the body of a lion and the head and wings of an eagle.
Griffolino of Arezzo: He duped Alberto da Siena saying, that for money, he would teach him to fly. As a result, Griffolino was burned at the stake for heresy by the Bishop of Siena, who favored Alberto, who was perhaps the Bishop's illegitimate son.
Guelphs and Ghibellines: Factions supporting, respectively, the Papacy and the Holy Roman Empire in Italy during the 12th and 13th centuries. After the Guelphs finally defeated the Ghibellines in 1289 at Campaldino and Caprona, (Dante apparently fought for the Guelphs at both), they began to fight among themselves. By 1300, Dante's city, Florence, was "divided" between the Black Guelphs, who continued to support the Papacy, and White Guelphs, Dante's party. That year the Whites defeated the Blacks and forced them out of Florence, however, in 1302, the Blacks, with the help of Pope Boniface VIII, were victorious and the Whites, including Dante, were banished from Florence. Inf. VI, 60вЂ“72.
The expulsion of the White Guelphs from Florence is prophesied: "Fiorenza rinnova gente e modi". Inf. XXIV, 143вЂ“150.
Guido del Cassero: See Malatestino.
Guido Guerra (c. 1220вЂ“1272): Member of one of the greatest Tuscan families, he was one of the leaders of the Guelph faction in Florence, under whose banners he fought the disastrous battle of Montaperti in 1260. Exiled following the triumph of the Ghibellines, he returned to Florence in 1267 when the Guelphs retook control of the city.
Guido Guinizelli: Italian poet (c. 1230вЂ“1276). Dante considered him the founder of his style of poetry (Dolce Stil Novo).
Guido da Montefeltro (1223вЂ“1298): Renowned leader of the Ghibellines of Romagna. As ruler of ForlГ¬, in 1282, he defeated a French force, which was besieging the city. In 1296 he retired from military life and entered the Franciscan order. Pope Boniface VIII, in 1297, asked his advice on how to capture Palestrina, the impegnable stronghold of the Colonna family, offering in advance papal absolution for any sin his advice might entail. He advised Boniface to promise the Colonnas amnesty, then break it. As a result, the Collonas surrendered the fortress and it was razed to the ground. Dante also mentions him in the Convivio, where he curiously extols his piety and sanctity.
Guido da Polenta: The powerful aristocratic ruler of Ravenna and Cervia, the former town taken by him in 1275 and the latter shortly after. He was father of Francesca da Rimini, and grandfather of Guido Novello da Ravenna, who was to give Dante hospitality in his last years. The coat of arms of his family contained an eagle.
Robert Guiscard (c. 1015вЂ“1085): One of the most remarkable of the Norman adventurers who conquered Southern Italy and Sicily. He was count (1057вЂ“1059) and then duke (1059вЂ“1085) of Apulia and Calabria after his brother Humphrey's death.
Guittone: Italian poet of the generation before Dante. Purg. XXVI, 55, 124.
Guy de Montfort: Son of Simon de Montfort, 6th Earl of Leicester (1208вЂ“1265) who was leader of the baronial opposition to king Henry III of England. Simon was killed at the battle of Evesham and Guy revenged his death by killing the king's nephew, another Henry, in a church in Viterbo.
Hadrian V: Pope for 38 days in 1276.
Hannibal: Ancient military leader of Carthage, who led an invasion of "Arabs" over the Alps into Italy in the Second Punic War in the late 3rd century BCE.
Harpies: Monsters from Greek mythology with human female faces on the bodies of birds.
Hector: The greatest Trojan warrior, in the Trojan War.
Hecuba: Wife of Priam king of Troy, mother of Hector, Paris, Polyxena and Polydorus. Captured after the fall of Troy, she went mad after seeing her daughter Polyxena, sacrificed on the tomb of Achilles and the corpse of her son Polydorus, murdered by Polymestor, King of Thrace (Euripides, Hecuba, Ovid Metamorphoses XIII, 429вЂ“575). According to Ovid she growled and barked like a mad dog.
Helen: Wife of the Spartan king Menelaus and lover of the Trojan Paris, her abduction caused the Trojan War.
Helicon: Mountain in Boeotia sacred to the Muses. Purg. XXIX, 40.
Heliodorus: Minister to Seleucus IV, Hellenistic ruler of the Seleucid Empire. According to II Maccabees 3:21вЂ“28, he was sent to Jerusalem to plunder the treasury of the Temple, but was turned back by supernatural figures, including a man mounted on a horse.
Heliotrope stone: Also called bloodstone, is dark green with spots of red. In the Middle Ages the red spots were thought to be the blood of Jesus, and it was believed to have miraculous powers, including making its wearer invisible. Boccaccio writes about it in his Decameron (VIII, 3). Inf. XXIV, 93.
Hellespont: Narrow strait connecting the Black Sea with the Aegean Sea and separating Europe from Asia Minor. In Herodotus' account of the Persian Wars, Xerxes, king of the Persians, spanned the Hellespont with a bridge to invade Greece. When a storm destroyed the bridge, the king ordered his soldiers to flog the waters as punishment.
Henry of England (Arrigo d'Inghilterra): Henry III (1216вЂ“1272)
Heraclitus (c. 535 вЂ“c. 475 BCE): Greek Presocratic philosopher.
Hera (Juno in Roman mythology): Greek goddess, she is the wife of Zeus (Jupiter). A jealous goddess, she often sought revenge against Zeus' many lovers. One of those was Semele, who was the daughter of Cadmus, King of Thebes and the mother of Dionysus by Zeus. One of Hera's many acts of revenge against Semele, was to cause Athamas, husband of Semele's sister Ino, to be driven mad. Mistaking Ino, holding their two infant sons Learchus and Melicertes, for a lioness and her cubs, he killed Learchus, and Ino still holding Melicertes jumped off a cliff into the sea. (Ovid, Metamorphoses IV, 416вЂ“542). Another lover of Zeus, and victim of Hera was Aegina, daughter of the river-god Asopus (see Aegina above).
Heracles (Latin: Hercules): Son of Zeus and Alcmene, he is probably the most famous Hero of Greek mythology. Of his many achievements, the most famous are the Twelve Labours.
Hippocrates (c. 460вЂ“380 BCE): Ancient Greek physician, often called "the father of medicine.".
Holofernes: According to the Book of Judith, an Assyrian general who invades Israel. He is killed by Judith, who seduces him in his tent.
Homer: Greek poet credited with the authorship of the epic poems the Iliad, which tells the story of the Trojan War, and the Odyssey, which tells the story of the Greek hero Odysseus' adventures returning from that war.
Horace: Latin lyric poet.
Hugh Capet: (c. 939вЂ“996) First King of the Franks and founder of the Capetian Dynasty.
Hypsipyle: Queen of Lemnos, she was seduced and abandoned by Jason while en route to the Colchis with the Argonauts.
Icarus: In Greek mythology, the son of the inventor Daedalus. They escaped from imprisonment in Crete using wings of feathers and wax invented by Daedalus. However, Icarus flew too near the sun, the wax melted, and he fell to his death.
Ilium: See Troy.
"In te, Domine, speravi" ("In Thee, o Lord, have I hoped"): Incipit of Psalm 31 in Latin (Psalm 30 in the Vulgate Bible)
"In exitu IsrГ¤el de Aegypto": ("When Israel came out of Egypt"): Latin incipit of Psalm 114 (Psalm 113 in the Vulgate Bible).
Indus River: major river of Asia which flows through present day Pakistan and India, with its source in the Tibetan Himalayas.
Ino: See Hera.
Alessio Interminelli: Member of a White Guelph noble family of Lucca. He probably died in 1295.
Iphigenia: In Greek legend, daughter of Agamemnon and Clytemnestra. Her father intended to sacrifice her in order to placate the gods who withholding winds to carry the Greek fleet to Troy.
Isaac: The biblical father of the patriarch Israel.
Isidore of Seville: Archbishop of Seville, and one of the great scholars of the early Middle Ages.
Ismenus and Asopus: Rivers in Boeotia in Greece, where festivals for Dionysus were held. Purg. XVIII, 91.
Israel: One name given to the biblical patriarch Jacob.
Jacopo da Santo Andrea: Notorious spendthrift from Padua. He may have been executed by Ezzelino da Romano in 1239.
Jason: Greek mythological hero who led the Argonauts to Colchis in search of the Golden Fleece.
Jason: Brother of the High Priest of Israel Onias III, he succeeded his brother in c. 175 BCE. According to 2 Maccabees he obtained his office by bribing the Seleucid king Antiochus IV Epiphanes.
Jephthah: Judge in ancient Israel who made a careless vow to offer up a sacrifice of thanksgiving for victory in battle and accidentally committed his daughter to that sacrifice. The story appears in Judges 11.
Jerusalem: Location of the Temple of Solomon and site of Jesus' crucifixion. Considered in the Middle Ages as the geographical center of the inhabited world.
Jesus: Central figure of Christianity. According to Christian legend, in what is called the Harrowing of Hell, he descended into Hell after his death and rescued certain souls from Limbo.
Jocasta: Wife and mother of Oedipus, ancient king of Thebes. They had two sons, Polynices and Eteocles. Statius' Thebaid tells the story of the family conflict.
John the Baptist: The desert prophet, who baptised Jesus. He became the patron saint of Florence, displacing the Roman Mars, and his image was stamped on the cities gold coin, the florin.
John the Evangelist: The name used to refer to the author of the Gospel of John. He is also traditionally identified with John the Apostle and the author of the Book of Revelation.
Dante interprets a passage of John's Revelation (17:1вЂ“3) as a prophecy on the future corruption of the Roman Curia. Inf. XIX, 106вЂ“108.
John's vision (Rev. 4:6вЂ“11) of four beasts in the heavenly court draws from a vision of similar beasts by the prophet Ezekiel (Ezekiel 1:1вЂ“21). The beasts appear as allegories of the four Gospels in the Pageant of the Church Triumphant. Purg. XXIX, 103вЂ“105.
Jordan: River on the border of Israel.
Jove: See Zeus.
Jubilee: The first Jubilee of the Roman Catholic church took place in 1300. Inf. XVIII, 28вЂ“33.
Judas Iscariot: Disciple who betrayed Jesus.
Julia : Daughter of Julius Caesar and wife of Pompey.
Julius Caesar (100вЂ“44 BCE): The celebrated Roman dictator and military commander.
Juno: See Hera.
Justinian: Flavius Petrus Sabbatius Iustinianus, an emperor of Byzantium, known as "the last Roman emperor". A saintly man respected for his law reforms.
Encountered in the Second Sphere: Mercury, as an unnamed "holy form [concealed] within his rays". Par. V, 115вЂ“139.
Juvenal: Decimus Iunius Iuvenalis, Roman poet of the 1st and 2nd centuries CE.
"Kill! Kill!" ("Martira, martira!"): The martyrdom of St. Stephen by an angry mob. He died without anger as he was stoned to death. His last words were a prayer for forgiveness for his enemies. (Acts 7:58вЂ“60)
"LabГЇa mГ«a, Domine": Abbreviation of "Domine, labia mea aperies; et os meum annunciabit laudem tuam." ("O Lord, open thou my lips, and my mouth shall proclaim thy praise.") (Psalm 51:15; Ps 50:15 in the Vulgate.) Verse recited at the beginning of the first monastic prayer office of the day.
Lacedaemon: Also known as Sparta, a leading city in ancient Greece.
Lachesis: One of the three Fates in Greco-Roman mythology. With a measuring rod, she measures out the life-span of every mortal.
Laertes: Mythical father of Odysseus (Ulysses), he was one of the Argonauts. In the Odyssey he takes part in the massacre of Penelope's suitors.
Lancelot: Central figure of the Arthurian legend. Reading tales of his amorous adventures led Paulo and Francesca astray.
Lano: See Arcolano of Siena.
Brunetto Latini: Famous Florentine Guelph politician and writer, friend and teacher of Dante until his death in 1294.
Encountered by Dante among the sodomites in the seventh circle. The meeting between Dante and Brunetto is one of the most important in the Inferno, as Brunetto is given the key role of prophesying the future exile of Dante. Dante extols his encyclopaedia, Li Livres dou Tresor, of which Dante has Brunetto say: "Sieti raccomandato il mio Tesoro, nel qual io vivo ancora". Inf. XV, 22вЂ“124.
Lateran Palace: The principle papal residence, from the beginning of the 4th century, until the beginning of Avignon Papacy, in 1305.
Latinus: The "Latian king" and one of a group of figures associated with the history of Troy, Virgil's Aeneid, and the history of Rome encountered by Dante in Limbo. Inf. IV, 121вЂ“128.
Lavinia: Daughter of Latinus and Amata and wife of Aeneas.
Lawrence: Deacon in the Church in Rome, martyred in 258. According to tradition, he was tied to a grate and burned to death.
Leah: Sister to Rachel, first wife of Jacob, and mother of six of the tribes of ancient Israel. She was the less attractive of the two sisters, but Jacob was tricked into marrying her first. (Gen 29:16вЂ“25)
Leander: Ancient Greek youth who carried on a love affair with Hero, a priestess of Aphrodite, who lived on the opposite shore of the Hellespont. Each night he would swim across the strait to be with her.
Learchus: See Hera.
Lethe: One of the rivers of Hades in Greek mythology. To drink its waters is to forget everything. In the Comedy, its source is in Terrestrial Paradise at the top of Purgatory. When it reaches the base of the mountain, it flows down a narrow passageway to the center of the earth.
Levi: Son of Jacob and Leah and eponymous forebear of a tribe of ancient Israel. The tribe of Levi was responsible for duties of worship and did not receive a tribal homeland.
Libra: Constellation of the zodiac. During the events of the Comedy, it would be highest in the sky at about 1 A.M.
Limbo: The first circle of Dante's Hell and the scene of Inf. IV. It is a kind of antechamber in which the souls of the good who died before Jesus spend eternity with no punishment other than the lack of the divine presence. In Dante's version, figures from Classical antiquity significantly outnumber those from the Old Testament.
Linus: Mythical son of Apollo who taught music to Orpheus.
Livy (c. 59 BCE вЂ“ 17 CE): The famous Roman historian author of the monumental Ab Urbe Condita, telling the history of Rome from the origins down to his own times.
Lombards: Germanic tribe who invaded Italy in the 6th century BCE and established a kingdom in the northern part of the peninsula.
Peter Lombard (c. 1090вЂ“1160): Theologian and Bishop; author of The Sentences, a famous medieval textbook of theology.
Lucan (39вЂ“65): Latin poet, whose Pharsalia, an epic poem on the civil war between Julius Caesar and Pompey, is an important source for Dante. Like Seneca he was forced to commit suicide by Nero for his participation in the Pisonian conspiracy.
Lucca: A Tuscan city of considerable importance in the Middle Ages; generally Guelph, it was traditionally an ally of Florence and an enemy of Pisa.
Dante, through the words of a devil, accuses its magistrates of being all corrupt: "torno...a quella terra, che n'ГЁ ben fornita: ogn'uom v'ГЁ barattier,...del no, per li denar, vi si fa ita" Inf. XXI, 39вЂ“42.
Lucia of Syracuse: (Saint Lucy) 4th-century martyr saint associated with light and those, like Dante, who suffered from poor eyesight. She symbolises Illuminating Grace in the poem.
Lucretia: Legendary woman in the history of the Roman Republic, whose rape by the son of king Tarquinius Superbus was revenged by Brutus when he overthrew the king.
Luke: Writer of the third Gospel. Luke includes a story of the resurrected Jesus quietly joining two disciples as they walked the road to Emmaus. (Luke 24:13вЂ“27)
Lycurgus: Ancient king of Nemea. According to Statius's Thebaid (V.499вЂ“730), Lycurgus received Hypsipyle and her two sons as refugees from Lemnos and put his own son in her care. When she accidentally permitted the Lycurgus' son to die of a snakebite, the enraged king wanted to kill her. Her two sons rushed to her side to protect her.
Paolo Malatesta: See Paolo and Francesca.
Malatesta da Verucchio: Founder of the powerful Malatesta family, he and his son Malatestino, were Guelph rulers of Rimini from 1295, who killed the chief members of the rival Ghibelline family, the Parcitati, including their leader Montagna de' Parcitati. Malatesta had two other sons Giovanni, who married Guido da Polenta's daughter Francesca, and Paolo who became her lover (see Paolo and Francesca).
Malatestino: Son of Malatesta da Verrucchio, after his father's death in 1312, he became Signore of Rimini. He had two nobles of Fano, Guido del Cassero and Angiolello di Carignano, drowned, after he had summoned them to a parley at Cattolica.
Malebolge ("evil-pouches"): The eighth circle of Dante's hell, it contains ten trenches wherein the ten types of "ordinary" fraud are punished.
Malebranche ("evil-claws"): In the Inferno, it is the name of a group of demons in the fifth pouch of the Malebolge. They are led by Malacoda ("evil-tail"), who assigns ten of his demons to escort Dante: Alichino, Calcabrina, Cagnazzo ("big dog"), Barbariccia (leads the ten), Libicocco, Draghignazzo, Ciriatto, Graffiacane ("dog-scratcher") Farfarello and Rubicante. Another Malebranche is Scarmiglione.
Manfred: King of Sicily from 1258 to 1266.
"Manibus, oh, date lilia plenis." ("O, give lilies by the handful."): Quotation from Virgil's Aeneid (VI.883).
Manto: Mythical daughter of Tiresias, from her father she inherited the power of prophecy.
Mantua: An important and ancient city in Lombardy. Its name is probably of Etruscan origin.
Marcia: Wife of Cato the younger.
Maremma: Area consisting of part of southern Tuscany (and partly coincident with the province of Grosseto) and some part of northern Latium (a bordering region of the province of Viterbo). in Dante's time it was a desolate marshland, plagued by malaria.
Mars: In Roman mythology, the god of war.
Marsyas: Ancient Greek who challenged Apollo to a contest of musical performance judged by the Muses. After Marsyas lost, Apollo flayed him to death.
Charles Martel of Anjou (1271вЂ“1295): son of Charles II of Naples.
Pope Martin IV: Pope from 1281 to 1285. According to Dante, he died after a gluttonous feast of eels and wine.
Mary: The mother of Jesus.
Souls on the terrace of sloth quote her "haste" (Luke 1:39) as a spiritual lesson. Purg. XVIII, 99вЂ“100.
Her call for more wine at the marriage at Cana (John 2:3) was for decorum and not because she wanted more wine. Lesson in temperance heard spoken from the tree on the terrace of the gluttonous. Purg. XXII, 142вЂ“144.
Master Adam: Possibly an Englishman, who came to Bologna by way of Brescia. He was employed by the Guidi, counts of Romena, to counterfeit the Florentine florin. Stamped with the image of John the Baptist, the florin contained 24 karats of gold. His contained 21, for which crime he was burned at the stake in 1281.
Matilda: Sole permanent resident of Terrestrial Paradise.
Saint Matthias: After Judas' betrayal and suicide, he took his place as one of the twelve apostles (Acts of the Apostles I:23вЂ“26). Late legends state he was either crucified in Colchis or stoned by the Jews.
Medea: Mythical daughter of Aeetes, king of Colchis, she helped Jason get the Golden Fleece, but was abandoned by him. She took revenge by killing their two children.
Medusa (also known as the Gorgon): In Greek mythology, a female monster whose gaze could turn people to stone. See Erinyes.
Megaera: See Erinyes.
Meleager: Ancient Greek hero who died when his mother completed the burning of a stick. Purg. XXV, 22.
Melicertes: See Hera.
Metellus: Lucius Caecilius Metellus, tribune of the plebs 49 BCE, resisted Julius Caesar when he wanted to plunder the treasury.
Michael: Archangel
Michal: daughter of King Saul and wife of King David.
Midas: legendary Phrygian king who greedily asked that all he touched be turned to gold.
Minerva: Roman goddess of wisdom, equivalent to the Greek goddess Athena.
Minos: A semi-legendary king of Crete, son of Zeus and Europa. In The Divine Comedy, he sits at the entrance to the second circle in the Inferno, which is the beginning of Hell proper. Here, he judges the sins of each dead soul and assigns it to its rightful punishment by indicating the circle to which it must descend. He does this by circling his tail around his body the appropriate number of times.
Minotaur: In Greek mythology, a creature that was half man and half bull. It was held captive by King Minos of Crete, inside the Labyrinth, an elaborate maze designed by Daedalus. It was slain by Theseus.
Miserere: ("Have mercy.") Incipit of Psalm 51 (Psalm 50 in the Vulgate Bible.) It is one of the Seven Penitential Psalms.
"Modicum, et non videbitis me; et iterum, modicum, vos videbitis me." ("In a little while, you will not see me; and in a little while, you will see me again.") Spoken by Jesus to his disciples at the Last Supper. John 16:16.
Mongibello: Sicialian name for Mount Etna, though to be Vulcan's furnace.
Mosca de' Lamberti: Ghibelline who in 1215 rekindled feuding with the Guelphs by urging the killing of the Guelph Buondelmonte dei Buondelmonte, for breaking a marriage engagement.
Mucius: Gaius Mucius Scaevola, ancient Roman soldier from a noteworthy family. When captured by enemies, he held his right hand in a fire to show his steadfast willingness to give his life for Rome.
Muhammad (c. 570вЂ“632): The founder of Islam.
Muses: In Greek and Roman mythology, the inspiring goddesses of song, poetry and art. It was a standard literary device to invoke their aid when undertaking a difficult writing task.
Myrrha: In Greek Mythology mother of Adonis, who in disguise committed incest with her father (Ovid, Metamorphoses, X, 298вЂ“502)
Nasidius: See Sabellus and Nasidius.
Neptune: God of the sea. Inf. XXVIII, 83.
"Neque nubent": ("Nor do they marry.") (Mat 22:30)
Nessus: See Centaur.
NiccolГІ: See Spendthrift Club.
Nicholas: Saint and Bishop of Myra in the 4th century. One legend about Nicholas is that he rescued three young poor girls from a life of prostitution by a secret gift of dowries.
Pope Nicholas III (c. 1220вЂ“1280): Born Giovanni Gaetano Orsini from an eminent Roman family, he was made cardinal by Innocent IV and became pope in 1277, where he distinguished himself for his ability as a politician.
Nimrod: Great-grandson of Noah. According to Genesis, he was a "mighty hunter" and King of Shinar. Legends about him have him in charge of building the Tower of Babel.
Nino de' Visconti: See Ugolino della Gherardesca.
Ninus: Mythical king of Assyria and eponymous founder of Nineveh, he was the husband of Semiramis.
Niobe: Queen of Thebes, whose seven sons and seven daughters were killed by Apollo and Diana after Niobe boasted she was superior to their mother Latona.
Nisus: Son of Hyrtacus and friend of Aeneas and Euryalus. He was mentioned in Virgil's Aeneid. вЂ“ One of those who "died for Italy". Inf. I, 106вЂ“108
Obizzo II d'Este: Marquess of Ferrara in 1264вЂ“1293 and a leading Guelph. Popular tradition had it that he was killed by his son, Azzo VIII.
Octavian: see Augustus.
Oderisi of Gubbio: 13th-century manuscript illuminator. None of his works survive.
Odysseus (Ulysses in Roman mythology): King of Ithaca, he was the son of Laertes, husband of Penelope and father of Telemachus. Known for his guile and resourcefulness, he is the hero of Homer's Odyssey, and a major character in the Iliad. During the Trojan War, with Diomedes, he stole the Palladium and conceived the trickery of the Trojan horse. He was famous for the twenty years it took him to return home from the war.
"Oh, my son, why have you done this to us?": Mary's speaks to her young son Jesus when he remained in Jerusalem without their knowledge or permission. (Luke 2:48)
"OMO": Letters seen formed by the eyes and nose-bridge of an emaciated human face. "Homo" in Latin means "human," and in Italian the word is "Uomo."
Sinibaldo degli Ordelaffi: Head of the noble Ordelaffi family and ruler of ForlГ¬ and the surrounding territory in Romagna from the end of the 13th century. His coat of arms contained a green lion.
Orestes: Son of Agamemnon and Clytemnestra. Orestes avenged his father's murder by killing his mother. He refused to let his friend Pylades take the blame for the act.
Paulus Orosius (c. 385вЂ“420): Historian and theologian; associate of St. Augustine.
Orpheus: Mythical Greek singer and poet who, like Dante, descended into the underworld.
Ottaviano degli Ubaldini (c. 1210вЂ“1250): Cardinal and prominent Ghibelline who was the only supporter of their cause at the Papal Court at the time of the Battle of Montaperti (see Farinata).
Ovid: Latin poet, whose Metamorphoses, is Dante's principle, mythological source.
Maghinardo Pagani da Susinana: Signore of Faenza on the river Lamone, and Imola on the river Santerno. Ghibelline by birth, he was a Guelph in Florence. His coat of arms was a white lion on a blue field.
Pageant of Church History: Elaborate allegorical representation of the history of the Christian Church which Dante witnesses in Purgatory. Purg. XXXII & XXXIII.
Pageant of the Church Triumphant: Elaborate allegorical representation of the Church Triumphant which Dante witnesses in Purgatory. Purg. XXIX & XXX.
The allegorical procession includes: Four beasts with multiple wings and eyes (Lion, Ox, Eagle, & Angel), representing the four Gospels. Ancient tradition associates the four beasts seen in the visions of Ezekiel (Ezekiel 1:4вЂ“14) and John (Revelation 4:6вЂ“8) to the four Gospels. Purg. XXIX, 88вЂ“105.
Palladium: A statue of Pallas Athena. Since it was believed that Troy could not be captured while it contained this statue, Odysseus (Ulysses) and Diomedes stole it during the Trojan War (Aeneid II, 228вЂ“240).
Pallas: Legendary ancient Roman youth who bravely fought and died for the liberties of early Rome. His story is recounted in the Aeneid, Book X.
Paolo and Francesca: Brother and wife, respectively, of Giovanni Malatesta. The pair were lovers and reputedly killed by Giovanni. Francesca was the daughter of Guido da Polenta.
Montagna de' Parcitati: Of the noble Parcitati family, he was head of the Ghibelline faction in Rimini until Malatesta da Verrucchio assumed control of the town in 1295. Montagna was first jailed and then treacherously murdered by Malatesta and his son Malatestino.
Paul: One of the apostles of Jesus.
Recalled by Dante as God's "Chosen Vessel" (Acts 9:15) for an ecstatic journey to the "third Heaven" (2 Corinthians 12:2вЂ“4). Inf. II, 28вЂ“32.
Appears bearing the "Sword of the Spirit" (Heb 4:12) in the Pageant of the Church Triumphant. Purg. XXIX, 139вЂ“141.
Paris: Trojan, son of Priam and Hecuba, brother of Hector, and abductor of Helen.
Parnassus: Mountain in Greece near Delphi associated with Apollo and the Muses.
PasiphaГ«: Wife of King Minos of Crete and mother of the Minotaur. According to Virgil's Eclogue VI, 45вЂ“60, she conceived by a bull while hiding inside a hollow wooden cow.
Paternoster: The "Lord's Prayer" taught by Jesus to his disciples.
Penelope: Faithful wife of Odysseus (Ulysses) king of Ithaca, refusing the many suitors who invaded her home, she waited twenty years for him to return home from the Trojan War.
Penthesilea: Queen of the Amazons, she fought on for Troy during the Trojan War.
Perillus: See Sicilian bull.
Pelorus: northeast promontory of Sicily.
Persius: Aulus Persius Flaccus. Roman writer of the 1st century BCE
Saint Peter: One of the apostles of Jesus, and first pope.
Par XXIV, Dante's "Examination of Faith" by St. Peter; his presence first described by Beatrice: "And she: 'O eternal light of the great man/ To whom Our Lord entrusted the same keys/ Of wondrous gladness that he brought below'." (trans. by Cotter, ln. 34вЂ“36).
St. Peter's Pine Cone: A colossal bronze pine cone cast in the 1st or 2nd century CE in Rome. Originally located in the Campus Martius, it is now located in a courtyard in the Vatican Museum.
PhaГ«ton: In Greek mythology, the son of Helios, the sun god. To prove his paternity, he asked his father to allow him to drive the chariot of the sun for one day. Unable to control the horses, PhaГ«ton almost destroyed the earth, but was killed by Zeus.
Philip IV of France (1268вЂ“1314): King from 1285, his reign is memorable for many reasons. In particular he is famous for having shattered the temporal ambitions of the popes.
Phlegethon: "River of fire", in Greek mythology, one of the rivers of Hades.
Phlegra: In Greek mythology, the site of Zeus's defeat of the Giants (Gigantes) at the end of the Gigantomachy. Inf. XIV, 58.
Phlegyas: In Greek mythology he was the ferryman for the souls that cross the Styx. Inf. VIII, 10вЂ“24.
Phoenix: Mythical bird, which at the end of its life-cycle, burns itself to ashes, from which a reborn phoenix arises.
Pholus: A wise Centaur and friend of Herakles. Inf. XII 72.
Pia de' Tolomei: A Sienese woman allegedly murdered by her husband, Paganello de' Pannocchieschi, who had her thrown from a window in Maremma.
Piccarda: Sister of Dante's friend Forese Donati who failed to carry out her lifelong monastic vow.
Pier da Medicina: Apparently a political intriguer in Romagna, of whom little is known. Early commentators say he sowed discord between the Malatesta and Polenta families.
Pier Pettinaio: (1180вЂ“1289) Sienese comb-seller remembered for his piety and honesty. Siena established a festival in his memory.
Pierides: Daughters of Pierus, king of ancient Macedon, who entered into a contest with the Muses.
Pilate: Roman governor of Judea, responsible for the crucifixion of Jesus.
Pillars of Hercules: Name given to the promontoriesвЂ”the Rock of Gibraltar in Europe and Monte Hacho near Ceuta in AfricaвЂ”that flank the entrance to the Strait of Gibraltar. According to legend, Heracles (Hercules), on his way to steal the cattle of Geryon split a mountain in half, thereby forming the Strait of Gibraltar and connecting the Atlantic Ocean to the Mediterranean. The pillars marked the western boundary of the classical world, beyond which it was unsafe to sail.
Pinamonte dei Bonacolsi: An able and shrewd politician he took advantage of the fights between Guelphs and Ghibellins that were dividing Mantua to establish himself in 1273 as supreme ruler of the city, founding a Signoria that was kept by his family until 1328.
Pisistratus: Athenian tyrant of the 6th century BCE. His wife angrily demanded the life of a young man seen publicly embracing their daughter. Pisistratus refused to succumb to anger and gives a mild reply.
Pistoia: A Tuscan town which in Dante's time had lost much of its autonomy, becoming a sort of Florentine dependency.
Plato: Greek philosopher and teacher of Aristotle. In Dante's day, his writings were less influential than those of his student.
Plautus: Roman poet of the 2nd century BCE.
Plutus: In Greek mythology, he was the personification of wealth. Dante almost certainly conflated him with Pluto, the Roman god of the Underworld. He is found in the fourth circle of Dante's hell, in which the greedy and prodigal are punished. Inf. VII, 1вЂ“15.
Pola: Italian seaport (now part of Croatia) famed for its Roman necropolis.
Polycletus: Ancient Greek sculptor, famous for his realism.
Polydorus: See Hecuba.
Polymestor: Ancient king of Thrace. He killed Polydorus, young son of the Trojan King Priam, to steal the treasure that the boy possessed.
Polynices: See Eteocles
Polyxena: Trojan daughter of Priam and Hecuba. In some accounts, Achilles fell in love with her, and was killed while visiting her. At the demand of Achilles' ghost, Polyxena is sacrificed on Achilles' tomb.
Pompey: Pompey "the Great" (106вЂ“48 BCE). Famous patrician Roman general.
Priam: King of Troy, husband of Hecuba, father of Hector and Paris.
Priscian: Eminent Latin grammarian active in 6th century who wrote the Institutiones grammaticae, extremely popular in the Middle Ages.
Proserpina: Roman goddess whose story is the myth of springtime. She was the daughter of Ceres and wife of Pluto, king of the underworld. In Greek mythology her name is Persephone.
Ptolemy (c. 85вЂ“165): Greek geographer, astronomer, and astrologer. His geocentric theory of the universe was the standard astronomical model of Dante's day.
Puccio Sciancato: Of the noble Ghibelline Florentine Galigai family, he was exiled in 1268 after the Guelphs' triumph, but accepted the peace brokered in 1280 by Cardinal Latino to reconcile the factions. He was nicknamed Sciancato ("lame").
Pygmalion: Ancient King of Tyre. He murdered his uncle and brother-in-law to obtain their wealth.
Pyrrhus: Either Achilles's son Neoptolemus, killer of Priam and many other Trojans, or Pyrrhus of Epirus, could be intended, although the latter was praised by Dante in his Monarchy (II, ix, 8).
"Qui lugent": ("Who mourn") An abbreviation of "Beati qui lugent quoniam ipsi consolabuntur." ("Blessed are they who mourn, for they shall be comforted") (Mat 5:4; 5:5 in the Vulgate)
Quintius: Lucius Quinctius Cincinnatus (520вЂ“430 BCE). Ancient Roman noble who assumed dictatorial powers in a crisis and then promptly relinquished them to return to his farm. The city of Cincinnati, Ohio, is named in his honor.
Rachel: Sister to Leah, second wife of Jacob, and mother of two of the tribes of ancient Israel, including Joseph and Benjamin. She was the more attractive of the two sisters, but Jacob was tricked into marrying Leah first. (Gen 29:16вЂ“25) She symbolises the contemplative life in the Comedy.
Rehoboam: King of ancient Israel. He was the son of Solomon and succeeded him on the throne. Because of his oppressive taxation, the northern tribes revolted and formed an independent kingdom.
"Rejoice, you who have overcome." ("Godi tu che vinci!"): A paraphrase combining "Rejoice and be exceeding glad," (Mat 5:12) with "To him that overcometh will I give to eat of the tree of life" (Rev 2:7).
Rhea: See Cronus.
Rinier da Corneto and Rinier Pazzo: Highwaymen who lived in Dante's day. Pazzo was excommunicated by Pope Clement IV, in 1268
Richard of St. Victor: One of the most important 12th-century mystic theologicans. A Scot, he was prior of the famous Augustinian abbey of Saint-Victor in Paris from 1162 until his death in 1173. His writings on mystical contemplation won him the title "Magnus Contemplator", the great contemplator.
Rubaconte: Former name of the bridge now known as Ponte alle Grazie in Florence. Located at the foot of a hill.
Ruggiere degli Ubaldini: See Ugolino della Gherardesca.
Jacopo Rusticucci: Florentine Guelph of Guido Cavalcanti's guild, active in politics and diplomacy.
Blames his wife for his sin: '"e certo fu la fiera moglie piГ№ ch'altro mi nuoce". Inf. XVI, 43вЂ“45.
Sabellus and Nasidius: Two soldiers of Cato's army in Lucan's poem Pharsalia (IX, 761вЂ“804), who are bitten by snakes, while marching in the Libyan Desert, after which their bodies "transform". Sabellus' transforms into a rotting formless mass; Nasidius' swells, then bursts.
Sabine Women: Young women abducted by Roman youths in the early days of Rome. Par. VI, 41.
Saladin: 12th-century Muslim leader renowned for his military prowess, generosity, and merciful attitude to his opponents during the Crusades.
Salve Regina: Hymn to the Virgin Mary used in evening services. The song addresses Mary from "the vale of tears."
Samaria: Region north of Jerusalem and west of the Jordan River. According to John 4:4вЂ“28, Jesus encountered a Samaritan woman at a well. Their dialogue is about spiritual thirst.
Sardinia: Italian Island north of Tunisia and south of Corsica. In Dante's time it was plagued by malaria.
Sannella: (Simonetti della Sannella) Italian noble family, latter known as Simonetti, one of the ancient Florentine families from the time of Cacciaguida.
Mentioned together with other noble families, such as: Arca, Soldanier, Ardinghi, and Bostichi Par. XVI.
Sapphira: early Christian woman who died along with her husband after they confessed to withholding money promised to the Church. (Acts 5:1вЂ“11)
Satan: Biblical angel who embodies evil and is the greatest foe of God and mankind.
Saturn: Seventh and outermost planet in the geocentric planetary theory in Dante's day.
Saul: First king of ancient Israel. He died by falling on his own sword after losing a battle at Gilboa.
Gianni Schicchi: Disguised as the Florentine Buoso Donati, who had just died, he dictated a new will, bequeathing to himself Donati's best mare.
Scipio: Roman general (236вЂ“183 BCE) who defeated Hannibal at the Battle of Zama.
Scorpius: Constellation in the form of a Scorpion and sign of the Zodiac.
Michael Scot (c. 1175вЂ“1234): Scottish mathematician, philosopher, alchemist and astrologer, honoured by popes and emperors, especially Frederick II, he developed a popular reputation as a magician and seer.
Scotland: see Anglo-Scottish War
Second Punic War: The second of the wars fought between Carthage and Rome (219вЂ“202). According to Livy, Hannibal sent to Carthage "a pile" of gold rings from the fingers of thousands of slaughtered Romans.
Semele: See Hera.
Semiramis: Legendary figure who was, in Dante's day, believed to have been sexually licentious after the death of her husband Ninus.
Seneca, Lucius Annaeus (c. 4 BCE вЂ“ 65 CE): Roman philosopher, statesman and dramatist, forced to commit suicide by Nero for his participation in the Pisonian conspiracy, called "morale" (moral), by Dante.
Sennacherib: King of Assyria (705вЂ“681 BCE). His failed siege of Jerusalem is discussed in II Kings, which notes the army's destruction by a plague sent by God and his later assassination by his sons.
Serchio: A river near Lucca.
Seven Deadly Sins: A list developed by Christian moralists of the principal vices. They include Pride (superbia), Greed (avaritia), Lust (luxuria), Envy (invidia), Gluttony (gula), Anger (ira), and Sloth (acedia).
Sextus Pompeius: Son of Pompey the Great and opponent of Julius Caesar, portrayed by Lucan as a cruel pirate (Pharsalia VI, 420вЂ“422).
Shepherd: reference to the Pope as chief shepherd of the Christian flock.
Criticized for failure to distinguish spiritual and secular powers. He can "chew the cud" (has wisdom) but does not "have cleft hooves" (have both spiritual and temporal authorities). See Lev 11:3. Purg. XVI, 98вЂ“99. He also has "joined the sword to the shepherd's crook." Purg. XVI, 109вЂ“110.
Sichaeus: First husband of Dido and ruler of Tyre, he was murdered by Dido's brother.
Sicilian bull: A brazen figure of a bull used as an instrument of torture. The echoing screams of its victims, roasting inside, were thought to imitate the bellowing of a bull. It was created by Perillus for the tyrant Phalaris. Its creator was also its first victim.
Silvester I: A saint, he was Pope from 314 to 335. In the Middle Ages, supported by a forged document called the "Donation of Constantine", it was believed that he had baptized Constantine and cured him of leprosy, and as a result, that he and his successors had been granted rule over Rome and the Western Roman Empire. For Dante, this event was the beginning of the ever-increasing worldly wealth and power of the papacy, and the corruption that went along with it.
Simon Magus: The magician (or proto-Gnostic) of Samaria. In the Acts of the Apostles (8:9вЂ“24) he is rejected by the apostle Peter for trying to buy the ability to confer the Holy Spirit. From his name is derived the word Simony.
Simonides: Greek poet of the 5th century BCE.
Simony: Sin of selling or paying for offices or positions in the church hierarchy (cf. barratry).
Sinon: In Virgil's Aeneid, he was a Greek warrior during the Trojan War, who, having pretended to change sides, convinced the Trojans to bring the Trojan Horse into Troy, thus allowing the Greek soldiers hidden within it to climb out after dark, open the gates to the city, and let in the Greek army, who then captured the city.
Siren: Seductive chimera, half-woman and half-bird, who lures sailors to shipwreck on rocks with her singing.
"Sitiunt": ("They thirst.") Abbreviation of "Beati qui esuriunt et sitiunt iustitiam quoniam ipsi saturabuntur." ("Blessed are those who hunger and thirst after righteousness, for they shall be satisfied.") One of the Beatitudes preached by Jesus in Matthew 5.
Socrates: Greek philosopher.
Reginaldo Scrovegni: One of the richest Paduan bankers. In expiation of his father's sin, his son Enrico commissioned the Cappella degli Scrovegni in 1300 that was frescoed by Giotto.
Sodom: Biblical city, which during the Middle Ages, became associated in Christian thinking with the sin of homosexuality. Sodomy, like usury, was viewed as a sin against nature.
Solomon: Biblical king; son of King David; proverbially the wisest of men.
Spendthrift Club (Brigata Spendereccia): A group of rich young Sienese nobles, devoted to squandering their fortunes on foolish extravagances and entertainments. Arcolano of Siena was a member.
Four of its members described by Capocchio: "Stricca", "NiccolГІ", "Caccia d'Asciano" and "Abbagliato". Inf. XXIX, 125вЂ“132.
Sordello: 13th-century Italian troubadour, born in Goito near Virgil's home town Mantua.
Statius: Publius Papinius Statius (c. 45 вЂ“ c. 96). Roman poet of the Silver Age and author of the Silvae, the Achilleid and the Thebais.
Stricca: See Spendthrift Club.
Strophades: See Harpies.
Styx: One of the rivers encircling Hades in the Aeneid (VI, 187, 425).
"Summae Deus clementiae": ("God of highest mercy.") Latin monastic hymn sung on Saturday mornings. Its third verse calls on God to consume our loins with a fire of divine love.
Swallow (Rondinella): Songbird. According to Ovid, Philomela, a princess from Athens, was raped by Tereus and then transformed into a songbird, generally identified as a nightingale.
Sylvius: See Aeneas.
Syrinx: Mythological Greek nymph who, escaping her sexual defilement, fled to a river and was converted into a hollow reed which sang as the wind blew.
Tagliacozzo: Site of a defeat by Manfred's nephew Conradin, by Charles of Anjou, who, following the advice of his general Erard ("Alardo") de Valery, surprised Conradin, with the use of reserve troops.
Tarpeian Rock: cliff on the Capitoline Hill in Rome, where an ancient temple to Saturn was located.
Tarquin: Last king of Rome, he was overthrown by Lucius Junius Brutus, considered the founder of the Republic.
Taurus: Zodiac constellation in the form of a bull.
Te Deum laudamus: "We praise Thee, O God." Ancient Latin hymn sung in the morning monastic offices. Also sung in special occasions of celebration.
Te lucis ante: "To Thee before the close of day." Latin hymn sung at Compline, the final monastic prayer office of the day.
Telemachus: Son of Odysseus (Ulysses) and Penelope, he plays an important role in the Odyssey. In the lost Telegony he appears to have married Circe and been granted immortality.
Temple: reference to the Templars, a military order founded during the Crusades.
Terence: Publius Terentius Afer. Roman playwright of the 2nd century BCE.
Terrestrial Paradise: According to the Comedy, Terrestrial Paradise is the Garden of Eden where the original man and woman first lived. (Gen 2 & 3) It is located at the top of the mountain of Purgatory. The events of Cantos XXVIII through XXXIII in the Purgatorio take place there.
Thebes: City of Ancient Greece.
ThaГЇs: A courtesan in Terence's Eunuchus. Perhaps misled by Cicero's commentary (De amicitia XXVI, 98), he places her among the flatterers.
Thales (c. 635вЂ“543 BCE): Greek philosopher.
Thaumas: Greek sea god, whose daughter is Iris, the goddess of rainbows.
Themis: Greek goddess of divine justice and one of the Oracles of Delphi.
Theobald V of Champagne (c. 1238вЂ“1270): The eldest son of Theobald IV of Champagne, on his death in 1253 he succeeded him as Count of Champagne and, as Theobald II, king of Navarre. He died childless in 1270.
Theological Virtues: Virtues granted to believers by God's grace. They include Faith, Hope and Love.
Theseus: Legendary king of Athens who visited the underworld and, in the version used by Dante, was rescued by Herakles.
Thetis: Noble ancient Greek woman. Wife of Peleus and mother of Achilles.
Thisbe: In a tale by Ovid (Metamorphoses IV, 55вЂ“166), Thisbe and Pyramus are lovers in ancient Babylon separated by a wall.
Thymbraeus: An epithet of Apollo derived from the town Thymbra, where there was a temple dedicated to him.
Tiber: River which runs through Rome and empties into the Tyrrhenian Sea.
Tigris and Euphrates: Rivers in the Middle East. According to Genesis 2, they had their origins in the Garden of Eden.
Timaeus: A dialogue of Plato where the celestial source and destiny of the human soul are discussed.
Tiresias: A mythical blind soothsayer who was transformed into a woman and then back into a man, seven years later. He has an important role in classical literature, including the Odyssey.
Tisiphone: see Erinyes.
Tithonus: Trojan lover of Eos, Titan of the Dawn.
Titus: Roman Emperor (79вЂ“81). As a general, he completed the campaign to put down a Jewish revolt and recapture Jerusalem in 70 CE. Par. VI, 92вЂ“93.
Tityas: Son of Gaia. Tityus was a giant killed by Zeus for attacking Leto.
Tobit: Protagonist of the ancient Jewish book of the same name. Tobit is conducted on a journey by the Archangel Raphael.
Tomyris: Queen of the Massagetae in the 6th century BCE. According to Herodotus, Cyrus the Great led a failed invasion of her lands. After his defeat and death in battle, Tomyris plunged his severed head into a wineskin filled with blood.
Torquatus: Titus Manlius Torquatus, Consul and Dictator in Rome during the 4th century, BCE.
Tours: City in France. Pope Martin IV was treasurer of the church there when he was elected pope in 1281.
Trajan: Roman Emperor (98вЂ“117) at the height of the Empire. According to Medieval legend, he was posthumously converted to Christianity by Pope Gregory the Great.
Troy: Also called Ilium, the site of the Trojan War, described in Homer's Iliad, and the home of Aeneas. The Greeks were victorious by means of the wooden Trojan Horse, which the Greeks left as a "gift" for the Trojans. The Trojans brought the horse through the gates into their walled city, and the Greek soldiers who had hid inside the horse were able to open the gates and let in the rest of the Greek army.
Tullio/Tully: See Cicero.
Turnus: A chieftain of the Rutuli whose conflict with Aeneas is the subject of the second half of the Aeneid, at the end of which he was killed by Aeneas in single combat (Aeneid II, 919)вЂ”one of those who "died for Italy". Inf. I, 106вЂ“108.
Tristan: Hero of medieval French romance, he was a Cornish Knight of the Round Table, and adulterous lover of Isolde.
Tuscany: region of Italy where Florence is located.
Typhon: Son of Tartarus and Gaia. Typhon was a giant with a hundred serpent heads.
Ugolino della Gherardesca: Leader of one of two competing Guelph factions in Pisa. In 1288 he conspired with the Archbishop Ruggiere degli Ubaldini to oust the leader of the other faction, his grandson Nino de' Visconti. Ugolino was, in turn, betrayed by Ruggiere and imprisoned with several of his sons and grandsons. They all died of starvation in prison.
Ulysses: See Odysseus.
Usury: The practice of charging a fee for the use of money; viewed by the medieval church as a sin because it went contrary to the idea that wealth is based on natural increase, which was believed to be a gift from God.
Urania: The ancient Muse of Astronomy. She became the Muse of poets describing sacred themes.
Varro: Either Publius Terentius Varro or Lucius Varius Rufus. Both were Roman writers of the 1st century BCE.
Venerable Bede: See Saint Bede.
Venetian Arsenal: Shipyard and naval depot for Venice, built c. 1104, in Castello sestiere, it was one of the most important shipyards in Europe, and was instrumental in maintaining Venice as a great naval power.
"Veni, sponsa, de Libano" ("Come with me from Lebanon, my spouse.") (Song of Solomon 4:8)
"Venite, benedicti Patris mei." ("Come, blessed of my Father.") (Mat 25:34)
Venus: Roman goddess of love. In Greek mythology she was known as Aphrodite.
Vespers: Evening monastic prayer service. As a reference to a period of time, Vespers is 3 P.M. to 6 P.M.
"Vinum non habent": "They have no wine." (John 2:3) Words spoken by Mary to Jesus at the wedding feast at Cana to prompt him to supply more wine for the feast.
"Virum non cognosco": ("I have not known a man.") The Virgin Mary's response to the angel's announcement of the virgin birth of her son Jesus.
Volto Santo ("Holy face") of Lucca: An early Byzantine crucifix made of very dark wood, greatly venerated as having been miraculously created.
Virgil (Publius Vergilius Maro) (70вЂ“19 BCE): Latin poet. He serves as Dante's guide through the Inferno and Purgatorio. In the absence of texts of Homer, the readers in the Middle Ages considered Virgil's Aeneid to be the great epic poem of the Classical world. In Dante's time, many believed that Virgil had predicted the arrival of Christianity in lines from his Eclogue IV: "at the boy's birth in whom/the iron shall cease, the golden race arise" (trans John Dryden). This made him doubly suited to his role as guide. He also symbolises Reason. Virgil accompanies Dante from Inf. I, 61 to Purg. XXX, 54.
Vitaliano del Dente: Paduan banker, he was podestГ  of Vicenza in 1304 and of Padua in 1307.
Vulcan: In Roman mythology, blacksmith of the gods and, with the help of the Cyclops, maker of thunderbolts for Jove.
Michel Zanche (died 1290): Governor of the giudicato of Logudoro, in Sardinia. He administered the province for King Enzo, son of the Emperor Frederick II. When Enzo was made prisoner in 1249, his wife divorced and married Zanche. The latter ruled Logudoro until 1290, when he was murdered by his son-in-law Branca Doria.
Zion: Mountain in Jerusalem where Solomon's Temple was constructed.
Zeno of Elea (c. 490 вЂ“ c. 430 BCE): Greek presocratic philosopher.
Zeus (also Jove or Jupiter): Chief god of Classical mythology.
Saint Zita (c. 1215вЂ“1272): Canonized in 1696, she is the Patron saint of all maids and domestics. In her city, Lucca, she was already, in life, an object of popular devotion and reputed a saint. In Dante's time, her fame had already made her a sort of patron saint of her city. The Elders of Saint Zita were ten citizens of Lucca who, along with the chief magistrate, were the rulers of the city.
